1111111111111
1000101000001
100E0C0001001
1C0000E0001C1
11111111010P1
1111111111111